110000000000110
010000000000010
111111000000110
010001000000010
010001100000010
111000111111110
001011100010000
001110100011100
001000100000100
001000000001100
000000000001000
000000000001000