011101001
111011111
011111110
011111100
111111010
010111111
011101110
011111110
011110010
