00000000000000000000000000000000
00000000000000000000000000000000
00000000000000000000000000000000
00000000000000000000000000000000
00000000000000000000000000000000
00000000000000000000000000000000
00000000110000000000011000000000
00000000010000000000001000000000
00000000111111000000011000000000
00000000010001000000001000000000
00000000010001100000001000000000
00000000111000111111111000000000
00000000001011100010000000000000
00000000001110100011100000000000
00000000001000100000100000000000
00000000001000000001100000000000
00000000000000000001000000000000
00000000000000000001000000000000
00000000000000000000000000000000
00000000000000000000000000000000
00000000000000000000000000000000
00000000000000000000000000000000
00000000000000000000000000000000
00000000000000000000000000000000
